0000000000000000000000000000000000000
0000000000000000000000000000000000000
0000000000000000000000000000010000000
0000000000000000000000000000000001000
0000000000000000000000000000000000000
0000000000000000000000000000000000000
0000000000000000000000000000100000000
0000000000000000000000000000000000000
0000000000000000000010000000000000000
00000P000000S000000000000000000000000
0000000000000100S00000000000000000S10
1100111111111111111111111111111111111
1100111111111111111111111111111111111
1100111111111111111111111111111111111
1100111111111111111111111111111111111
1100111111111111111111111111111111111
1100111111111111111111111111111111111
1100111111111111111111111111111111111
1100111111111111111111111111111111111
1100111111111111111111111111111111111