0000000000000000000000000000000000000
0000000000000000000000000000000000000
0000000000000000000000000000000000000
0000000000000000000000000000000000000
0000000000000000000SsSsSsS00000000000
0000000000000000000000000000000000000
0000000000000000000000000000100000000
0000000000000000000000000000000000000
0000000000000000000010000000000S00000
0000000000000000000000000000000000000
0000000000000100000000000000000000010
1111111111111111111111111111111111111
1111111111111111111111111111111111111
1111111111111111111111111111111111111
1111111111111111111111111111111111111
1111111111111111111111111111111111111
1111111111111111111111111111111111111
1111111111111111111111111111111111111
1111111111111111111111111111111111111
1111111111111111111111111111111111111